:+1:	positive
:-1:	negative
:angry:	negative
:anguished:	negative
:astonished:	intensity
:bandaged:	negative
:beers:	hyper-satisfaction
:beers:	positive
:birthday:	hyper-satisfaction
:birthday:	positive
:blossom:	positive
:blue_heart:	positive
:blush:	positive
:bomb:	intensity
:boom:	intensity
:bouquet:	positive
:broken_heart:	negative
:casket:	negative
:champagne:	hyper-satisfaction
:champagne:	positive
:cherries:	positive
:clap:	hyper-satisfaction
:clap:	positive
:coffin:	negative
:collision:	intensity
:confused:	negative
:confounded:	negative
:confounded_face:	negative
:congratulations:	positive
:couple_with_heart:	positive
:couple_with_heart_man_man:	positive
:couple_with_heart_woman_woman:	positive
:couplekiss:	positive
:couplekiss_man_man:	positive
:couplekiss_woman_woman:	positive
:cry:	negative
:crying_cat_face:	negative
:disappointed:	negative
:dizzy_face:	negative
:exclamation:	intensity
:exclamation_heart:	hyper-satisfaction
:exclamation_heart:	positive
:expressionless:	negative
:eye_roll:	negative
:face_palm:	negative
:face_vomiting:	negative
:face_with_head_bandage:	negative
:head_bandage:	negative
:face_with_open_mouth_vomiting:	negative
:face_with_tears_of_joy:	hyper-satisfaction
:face_with_tears_of_joy:	positive
:face_with_thermometer:	positive
:facepalm:	negative
:fearful:	negative
:female_facepalm:	negative
:fire:	intensity
:fox:	positive
:fox_face:	positive
:frowning:	negative
:frowning_face:	negative
:funeral:	negative
:gift_heart:	hyper-satisfaction
:gift_heart:	positive
:green_heart:	positive
:grimacing:	negative
:grin:	positive
:grinning:	positive
:hankey:	negative
:head_bandage:	negative
:head_bandaged:	negative
:heart:	positive
:heart_decoration:	positive
:heart_decoration:	positive
:heart_eyes:	hyper-satisfaction
:heart_eyes:	positive
:heartbeat:	positive
:hearts:	hyper-satisfaction
:hearts:	positive
:heavy_exclamation_mark:	intensity
:high_brightness:	hyper-satisfaction
:high_brightness:	positive
:hug:	positive
:hugging:	positive
:hugs:	positive
:ill:	negative
:injured:	negative
:injured:	negative
:innocent:	positive
:joy:	hyper-satisfaction
:joy:	positive
:joy_cat:	positive
:kiss:	positive
:kissing:	positive
:kissing_closed_eyes:	positive
:kissing_heart:	positive
:kissing_smiling_eyes:	hyper-satisfaction
:kissing_smiling_eyes:	positive
:laughing:	positive
:love_letter:	positive
:military_decoration:	hyper-satisfaction
:military_decoration:	positive
:military_medal:	hyper-satisfaction
:military_medal:	positive
:musical_note:	positive
:neutral_face:	neutral
:no_good:	negative
:notes:	positive
:ok_hand:	positive
:person_frowning:	negative
:person_with_pouting_face:	negative
:poop:	negative
:princess:	positive
:rage:	negative
:raised_hands:	positive
:raising_hands:	positive
:relaxed:	positive
:relieved:	positive
:revolving_hearts:	positive
:rolling_eyes:	negative
:satisfied:	positive
:shit:	negative
:sick:	negative
:sleepy:	negative
:slightly_frowning:	negative
:slightly_smiling:	positive
:smile:	positive
:smiley:	positive
:smiling_face_with_smiling_eyes:	hyper-satisfaction
:smiling_face_with_smiling_eyes:	positive
:smirk:	positive
:sneezing_face:	negative
:sneeze:	negative
:sob:	negative
:sparkles:	hyper-satisfaction
:sparkles:	positive
:sparkling_heart:	hyper-satisfaction
:sparkling_heart:	positive
:sparkling_wine:	hyper-satisfaction
:sparkling_wine:	positive
:sports_decoration:	positive
:sports_medal:	positive
:star2:	positive
:stuck_out_tongue_closed_eyes:	positive
:stuck_out_tongue_winking_eye:	positive
:sunglasses:	positive
:sunrise:	positive
:sunrise_over_mountains:	positive
:sweat:	negative
:sweat_smile:	positive
:thermometer_face:	negative
:thermometer_face:	negative
:thumbsdown:	negative
:thumbsup:	positive
:tired_face:	negative
:triumph:	hyper-satisfaction
:triumph:	positive
:trophy:	hyper-satisfaction
:trophy:	positive
:two_hearts:	positive
:two_men_holding_hands:	positive
:two_women_holding_hands:	positive
:unamused:	negative
:vomiting_face:	negative
:weary:	negative
:wedding:	positive
:wink:	positive
:worried:	negative
:worried_face:	negative
:yellow_heart:	positive
:yum:	positive
